
WE ./wood.xpm
R 1080 720

NO ./grey.xpm


SO ./glace.xpm
F 129,120,191



EA ./colorstone.xpm
C 219, 104, 15
S ./barrel.xpm



111111111111111111
100000000000000001
10000111000000W001
100001111110000001
100000000000200001
100001110000000001
100001100000000001
100000000000000001
10000000000000000011111111
10000001100020000000000001
10000001100000000001110001
10020000000000011000000001
10000000000000000000000001
11111111111111111111111111
