
WE ./wood.xpm
R 2048 1080

NO ./greygoo.xpm       


SO ./glace.xpm
F 129,120,191



EA ./colorstone.xpm
C 219, 104, 15
S ./barrel.xpm


111111111110111111
100011000001001111
100001110002000001
100001111110000001
100000000000200001
100001110000000001
1000011000000W0001
1000000   00000001
10000000000000000011111111
10000001100020000000000001
10000001100000000001110001
10020000000000011000000001
10000 00000000000000000001
11111111111111111111111111

