
WE ./wood.xpm
R 2048 1080

NO ./greygoo.xpm       


SO ./eridu262.xpm
F 129,120,191



EA ./colorstone.xpm
C 219, 104, 15
S ./barrel.xpm


11111
10001
100W1
11011
11111