
WE ./wood.xpm
R 2048 2800

NO ./greygoo.xpm       


SO ./eridu262.xpm
F 129,120,191



EA ./colorstone.xpm
C 219, 104, 15
S ./barrel.xpm


11111111
10002001
100W0001
11000001
11111111